0000000000000
0100110011100
0111110011110
0111110001100
0011100001110
0011110011110
0011111111110
0011111111100
0111011111110
0111111111110
1111100011110
0000000000000
0000000000000
