0000000000000
0001111101000
0001000101000
0001000101000
0001111111000
0000000111000
0001111111000
0001000110000
0001000110000
0001001111100
0001001010100
1111111011100
0000000000000
