0000000000000
0000000000000
0011111111100
0010000000100
0010000000100
0010000000100
0010000000100
0010000000100
0010000000100
0010000000100
1111111111100
0000000000000
0000000000000
