0000000000000
0011111111100
0110001000000
0111001111100
0101111110100
0100111000100
0110000111100
0011111100000
0010001111110
0011110000010
0000010111110
1111111100000
0000000000000
