00000000000000000000
00000000000000000000
00011111111111111110
00011110000000000010
00011110000000000010
00010000000000000010
00010000000000000010
00010000000000000010
00010000000000000010
00010000000000000110
11111111111111111110
00010000000000000010
00011111111111111110
00000000000000000000
00000000000000000000
00000000000000000000
00000000000000000000
00000000000000000000
00000000000000000000
00000000000000000000
