00000000000000000000
00111111000011111100
00100001000010000100
00100001000010000100
00100001000010000100
00100001000010000100
00100001000010000100
00111111111111111100
00000001000010000000
00000001000010000000
00000001000010000000
00000001000010000000
00000001000010000000
00000001000010000000
00000001000010000000
00000001000010000000
11111111000011111111
00000000000000000000
00000000000000000000
00000000000000000000
