0000000000000
0111001111110
0101001010010
0111111111110
0001001010000
0111111111110
0101000010010
0101111111110
0101001010010
0111111111010
0100001010010
1111111011110
0000000000000
