0000000000000
0001111111110
0011111111110
0110000000110
0110000000110
0110000000110
0110000000110
0110000000110
0110000000110
0111111111100
1111111111000
0000000000000
0000000000000
